NO ./test_files/textures/fn1.xpm
SO ./test_files/textures/fs.xpm
WE ./test_files/textures/fw.xpm
EA ./test_files/textures/fe.xpm

C 0,150,200
F 141,242,158



000001
111110111111111111111111111111
1N00000000000000000000000000001
111110111111111111111111111111
     1