NO ./test_files/textures/text.xpm
SO ./test_files/textures/text.xpm
WE ./test_files/textures/text.xpm
EA ./test_files/textures/text.xpm

C 0,150,200
F 141,242,158


1111
1W 1
1111
