NO    ./textures/text.xpm
SO ./textures/text_2.xpm
WE ./textures/text.xpm
EA ./textures/text_2.xpm

F 20,20  ,20
C 200,2000,2





111111111111111111111
10001
10001
10001
10001
10001
11001
10001
100N1
10001
10001
10001
1111110011111111101111111